|-----------|
|...c.......|
|..----.....|
|....|@.....|
|...c.......|
|-----------|