|-----------|
|...c.......|
|..----...|.|
|.....@...|.|
|...c---....|
|-----------|